1111
1P01
1011
10E1
1C01
1111
