11111111111111
1P00000E000001
10110000000C11
1011C000001111
10000000000001
11111111111111
