1111111111111111111111111111111111111111111111
1P00000000000000000000000000000000000000000001
1000000000000000000000000000000000000000000011
10000000000000000000000000000000000000000000E1
1C00000000000000000000000000000000000000000001
1111111111111111111111111111111111111111111111
