111111111111111111
111000000000000001
1CE000111111111101
11P010000000000001
11111100000000 011
100000000000000001
111111111111111111
