111111111111111111111111
1P000000000000C000000101
10110000000C1100000E1001
1011C0000011101011010001
100000000000000000000001
10000000000C001111100001
100011111000001100C00001
10001011100000C001000001
10000C000C000000C1001101
111111111111111111111111
