1111111111111111
10010000000C1115
1000011111001554
1P0011E000001564
1111111111111545
