1111111111111111
10E10000011C1111
1000011111001111
1P00110000001111
1111111111111111
