1111111111111111
10010000000C1111
1000011111001551
1P0011E000001561
1111111111111541
