1111111111111111
10E10000000C1111
1000011111001111
1P0011E000001111
1111111111111111
