1111111111111111111
1PC00000000G00000E1
1000000000000000001
1111111111111111111
