1111111111111111111
1PC0G000000G00000C1
1000000000000000001
1000000G0000C0000E1
1000C00000G000G0001
1111111111111111111
